10 10 10 10 10 10 10 10 10 10 10 10 10 10 10 10 10 10 10 10 
10 10 10 10 10 10 10 10 10 10 10 10 10 10 10 10 10 10 10 10 
10 10 10 10 10 10 10 10 10 10 10 10 10 10 10 10 10 10 10 10 
10 10 10 10 10 10 10 10 10 10 10 10 10 10 10 10 10 10 10 10 
10 10 10 10 10 10 10 10 10 10 10 10 10 10 10 10 10 10 10 10 
10 10 10 10 10 10 10 10 10 10 10 10 10 10 10 10 10 10 10 10 
10 10 10 10 10 10 11 5 5 5 5 5 5 12 10 10 10 10 10 10 
10 10 10 10 10 10 6 39 39 39 38 38 38 6 10 10 10 10 10 10 
10 10 10 10 10 10 6 39 39 39 38 38 38 6 10 10 10 10 10 10 
10 10 10 10 10 10 6 39 39 39 38 38 38 6 10 10 10 10 10 10 
10 10 10 10 10 10 6 37 37 37 40 40 40 6 10 10 10 10 10 10 
10 10 10 10 10 10 6 37 37 37 40 40 40 6 10 10 10 10 10 10 
10 10 10 10 10 10 6 37 37 37 40 40 40 6 10 10 10 10 10 10 
10 10 10 10 10 10 14 5 5 5 5 5 5 13 10 10 10 10 10 10 
10 10 10 10 10 10 10 10 10 10 10 10 10 10 10 10 10 10 10 10 
10 10 10 10 10 10 10 10 10 10 10 10 10 10 10 10 10 10 10 10 
10 10 10 10 10 10 10 10 10 36 10 10 10 10 10 10 10 10 10 10 
10 10 10 10 10 10 10 10 10 10 10 10 10 10 10 10 10 10 10 10 
10 10 10 10 10 10 10 10 10 10 10 10 10 10 10 10 10 10 10 10 
10 10 10 10 10 10 10 10 10 10 10 10 10 10 10 10 10 10 10 10 
-
