11 5 5 5 5 5 5 5 5 5 5 5 5 5 5 5 5 5 5 12 
6 35 10 10 10 10 10 10 10 10 10 10 10 10 10 10 10 10 35 6 
6 10 10 10 10 10 10 10 10 10 36 10 10 10 10 10 10 10 10 6 
6 10 10 11 5 5 5 5 5 5 5 5 5 5 5 5 12 10 10 6 
6 10 10 10 10 10 10 10 10 10 10 10 10 10 10 10 10 10 10 6 
6 10 10 6 10 10 10 10 10 10 10 10 10 10 10 10 6 10 10 6 
6 10 10 6 10 10 6 10 10 10 10 10 10 6 10 10 6 10 10 6 
6 10 10 6 10 10 6 10 6 7 7 6 10 6 10 10 6 10 10 6 
6 10 10 6 10 10 6 10 6 10 10 6 10 6 10 10 6 10 10 6 
6 10 10 10 10 10 10 10 6 37 39 6 10 10 10 10 10 10 10 6 
6 10 10 6 10 10 6 10 6 38 40 6 10 6 10 10 6 10 10 6 
6 10 10 6 10 10 6 10 6 10 10 6 10 6 10 10 6 10 10 6 
6 10 10 6 10 10 6 10 14 5 5 13 10 6 10 10 6 10 10 6 
6 10 10 10 10 10 10 10 10 10 10 10 10 10 10 10 10 10 10 6 
6 10 10 6 10 10 14 5 5 10 10 5 5 13 10 10 6 10 10 6 
6 10 10 6 10 10 10 10 10 10 10 10 10 10 10 10 6 10 10 6 
6 10 10 14 5 5 10 5 5 10 10 5 5 10 5 5 13 10 10 6 
6 10 10 10 10 10 10 10 10 10 10 10 10 10 10 10 10 10 10 6 
6 35 10 10 10 10 10 10 10 10 10 10 10 10 10 10 10 10 35 6 
14 5 5 5 5 5 5 5 5 5 5 5 5 5 5 5 5 5 5 13 
-
