11 5 5 5 5 5 5 5 5 15 5 5 5 5 5 5 5 5 12 
6 35 10 10 10 10 10 10 10 6 10 10 10 10 10 10 10 35 6 
6 10 1 3 10 1 5 3 10 4 10 1 5 3 10 1 3 10 6 
6 10 10 10 10 10 10 10 10 10 10 10 10 10 10 10 10 10 6 
6 10 1 3 10 2 10 1 5 15 5 3 10 2 10 1 3 10 6 
6 10 10 10 10 6 10 10 10 6 10 10 10 6 10 10 10 10 6 
14 5 5 12 10 18 5 3 10 4 10 1 5 16 10 11 5 5 13 
20 20 20 6 10 6 10 10 10 37 10 10 10 6 10 6 20 20 20 
5 5 5 13 10 4 10 11 3 7 1 12 10 4 10 14 5 5 5 
10 10 10 10 10 10 10 8 38 39 40 8 10 10 10 10 10 10 10 
5 5 5 12 10 2 10 14 5 7 5 13 10 2 10 11 5 5 5 
20 20 20 6 10 6 10 10 10 10 10 10 10 6 10 6 20 20 20 
11 5 5 13 10 4 10 1 5 15 5 3 10 4 10 14 5 5 12 
6 10 10 10 10 10 10 10 10 6 10 10 10 10 10 10 10 10 6 
6 10 1 12 10 1 5 3 10 4 10 1 5 3 10 11 3 10 6 
6 10 10 6 10 10 10 10 10 36 10 10 10 10 10 6 10 10 6 
18 3 10 4 10 2 10 1 5 15 5 3 10 2 10 4 10 1 16 
6 10 10 10 10 6 10 10 10 6 10 10 10 6 10 10 10 10 6 
6 10 1 5 5 17 5 3 10 4 10 1 5 17 5 5 3 10 6 
6 35 10 10 10 10 10 10 10 10 10 10 10 10 10 10 10 35 6 
14 5 5 5 5 5 5 5 5 5 5 5 5 5 5 5 5 5 13 
-
