11 5 5 5 5 5 5 5 5 5 5 5 5 5 5 5 5 5 5 5 5 5 12 
6 10 10 10 10 10 10 10 10 10 10 10 10 10 10 10 10 10 10 10 10 10 6 
6 10 21 25 25 22 10 21 25 25 22 10 21 25 25 22 10 21 25 25 22 10 6 
6 10 28 20 20 26 10 28 20 20 26 10 28 20 20 26 10 28 20 20 26 10 6 
6 10 24 27 27 23 10 24 27 27 23 10 24 27 27 23 10 24 27 27 23 10 6 
6 10 10 10 10 10 10 10 10 10 10 10 10 10 10 10 37 10 10 10 10 10 6 
6 10 21 25 25 22 10 21 25 25 22 10 21 25 25 22 10 21 25 25 22 10 6 
6 10 28 20 20 26 10 28 20 20 26 10 28 20 20 26 10 28 20 20 26 10 6 
6 10 24 27 27 23 10 24 27 27 23 10 24 27 27 23 10 24 27 27 23 10 6 
6 10 10 10 10 10 10 10 10 10 10 10 10 10 10 10 10 10 10 10 10 10 6 
6 10 21 25 25 22 10 21 25 25 22 10 21 25 25 22 10 21 25 25 22 10 6 
6 10 28 20 20 26 10 28 20 20 26 10 28 20 20 26 10 28 20 20 26 10 6 
6 10 24 27 27 23 10 24 27 27 23 10 24 27 27 23 10 24 27 27 23 10 6 
6 10 10 10 10 10 36 10 10 10 10 10 10 10 10 10 10 10 10 10 10 10 6 
6 10 21 25 25 22 10 21 25 25 22 10 21 25 25 22 10 21 25 25 22 10 6 
6 10 28 20 20 26 10 28 20 20 26 10 28 20 20 26 10 28 20 20 26 10 6 
6 10 24 27 27 23 10 24 27 27 23 10 24 27 27 23 10 24 27 27 23 10 6 
6 10 10 10 10 10 10 10 10 10 10 10 10 10 10 10 10 10 10 10 10 10 6 
14 5 5 5 5 5 5 5 5 5 5 5 5 5 5 5 5 5 5 5 5 5 13 
-
