5 5 5 5 5 5 5 5 5 5 5 5 5 5 5 5 5 5 5 5 10 10 10 10 10 10 10 10 10 
5 10 10 10 10 10 10 10 10 7 10 10 10 10 10 10 10 10 10 10 5 5 5 5 5 5 5 5 5 
5 10 10 10 10 10 10 10 7 7 10 10 10 35 10 10 10 35 10 10 10 10 10 10 10 10 10 11 10 
5 7 10 10 10 10 10 10 7 7 10 10 10 10 35 35 35 35 35 35 35 10 10 10 10 10 10 11 10 
5 10 7 7 10 10 10 10 7 35 35 35 35 35 10 10 10 10 10 35 10 35 10 10 10 10 10 11 10 
5 10 10 7 7 7 35 35 7 10 10 10 10 10 10 10 10 10 10 35 10 10 35 10 10 10 10 11 10 
5 10 10 10 10 7 7 7 10 10 10 10 10 10 39 10 10 10 35 10 10 35 10 10 10 10 10 11 10 
5 10 10 10 35 35 10 10 10 10 10 10 9 9 10 10 10 10 35 11 15 10 10 10 10 10 10 11 10 
5 10 10 10 35 10 10 10 10 10 10 10 9 9 10 10 35 35 10 38 35 10 10 10 10 10 20 11 10 
5 10 10 10 35 10 10 10 10 21 21 21 21 9 10 35 35 10 10 10 10 10 10 10 20 20 10 11 10 
5 10 10 10 35 35 10 10 10 21 36 10 35 35 35 35 20 35 20 20 20 20 20 20 10 10 10 11 10 
5 10 10 35 10 35 35 35 35 35 35 35 35 10 35 35 10 35 10 10 10 10 19 19 19 10 10 11 10 
5 10 10 10 10 41 41 41 41 10 10 35 35 35 35 35 19 35 10 10 10 35 10 10 19 10 10 11 10 
5 10 10 35 10 41 10 10 10 10 35 35 35 10 35 35 10 35 10 10 10 10 10 35 19 10 10 11 10 
5 10 10 35 35 41 10 10 35 35 10 10 35 35 10 19 35 35 10 10 35 10 35 10 19 10 10 11 11 
5 10 10 10 35 35 10 41 10 10 10 10 35 10 19 35 35 35 35 19 35 35 10 19 19 19 10 5 11 
5 10 10 10 10 10 10 10 41 10 41 10 35 10 19 35 19 35 35 35 10 10 10 10 10 10 5 5 11 
5 10 10 10 10 10 10 10 10 10 10 41 41 35 35 35 35 35 10 10 41 41 10 10 10 10 5 10 11 
5 10 10 10 10 10 5 5 5 5 5 10 41 41 10 10 10 10 41 10 41 10 10 10 5 5 10 10 10 
5 5 5 5 5 5 5 10 10 10 5 5 5 5 5 5 5 5 5 5 5 5 5 5 5 10 10 10 10 
-
